NO textures/kyaubry.xpm
SO textures/mur.xpm
EA textures/karl.xpm
WE textures/sheldon2-resized.xpm
D textures/door2.xpm
A1 textures/cat_closed.xpm
A2 textures/cat_open.xpm

F 0,0,0
C 150,240,255

1111111111111111111111111
1000000000110000000000001
10110S0001110000000000001
1001000000D0000000000000111111111
11111A1110110000011100000000D0001
100000000011000001110111101011111
11110111111111011100000010001
111101111111110111010100100011000
11000000110101011100000010001111111111111111111111
10000000000000001100000010A00DDDDDDDD000000000001
1000000000000000110101001000111111111111111111111
11000001110101011111011110001
11110111 1110101D101111010001
11111111111111111111111111111
