NO textures/maxime.xpm
SO textures/kyaubry-resized.xpm
EA textures/karl.xpm
WE textures/sheldon2-resized.xpm
D textures/door2.xpm

F 0,0,0
C 150,240,255

1111111111111111111111111
1000000000110000000000001
1011000001110000000000001
10010000000000000000000011111111111111111
111111111011000001110000000000001
10000000001100000111011110100111
11110111111111011100000010001
111101111111110111010100100011000
11000000110101011100000010D01111111111111111111
10000000000000001100000010D0DDDDDDDDDDDDDDDDD1
10000000000000001101010010D0111111111111111111
11000001110101011111011110N01
11110111 1110101 101111010001
11111111111111111111111111111
